################
#    *x* * *   #
#    #  # *# #*#
#  #   #  *    #
##    *## *  **#
#    *  #* *** #
##   **      * #
#  *      * #* #
#*    * x #  * #
##      ## **# #
#*#  **  #*    #
# * #   #*  ** #
#   #  * #     #
#    * #* * # *#
#*  * ** *   # #
################
