####################
#    #  * U   ##   #
#   *   #    *  #  #
#           U      #
#  #   O      *   ##
#    #  # *    #  *#
# # O   #     *    #
# * #      # # **  #
#  ** * *#       O #
#  #    ** #   *   #
#     *   U    #   #
#  # * *    #   *  #
# O   **#          #
##  *#     *** #  *#
#   *  *  **    *  #
#   *   #    *     #
# #  *    #*     * #
#   #  **#  #     ##
#*  x    U        *#
####################
