####################
#***   *      ## #*#
#       *    #  *  #
# # ## #  ##  *  * #
# x    *  x#   * **#
#  #   *   **    * #
# **# #      * #   #
#   * *  *#  #  *  #
#*  * * * #**#  *  #
#  #* ## # #  *    #
#*   *             #
#    *# *  **#     #
#*# ** ***   * #x  #
# # * #     *      #
####################
