####################
#    #  * U   ##   #
#   *   #    *  #  #
#           U      #
#  #          *   ##
#    #  # *    #  *#
# #     #     *    #
# * #      # # **  #
#  ** * *#         #
#  #    ** #   *   #
#     *   U    #   #
#  # * *    #   *  #
#     **#          #
##  *#     *** #  *#
#   *  *  **    *  #
#   *   #    *     #
# #  *    #*     * #
#   #  **#  #     ##
#*  x    U        *#
####################
