13 31
###############################
#P  1 * * *  U * O *  * * 2   #
# # # #*# # #*#*# # # #*#*#*# #
#  x*   O ***  *  U   * O * * #
# # # # # #*# # #*#*# # # # #*#
#   O      x **  *  *   U     #
# # # # # # # # # #*# #*# # # #
#*  *   1  *  *2     *        #
# # # # #*# # # #*#*# # # # # #
#*    **  *   4   *     U     #
# #*# # # # # # #*# # # # # # #
#  O   1    *   *  *    O     #
###############################