####################
#*   *    *  *x #  #
#  # #  #   #   *  #
#   * #   #        #
#  #          *   ##
#    #  # *    #  *#
# #     #     *    #
# * #      # # **  #
#  ** * *#         #
#  #    ** #   *   #
#     *        #   #
#  # * *    #   *  #
#     **#          #
##  *#     *** #  *#
#   *  *  **    *  #
#   *   #    *     #
# #  *    #*     * #
#   #  **#  #     ##
#*  x    *  #*    *#
####################
