####################
#  #  **     *  #  #
#     #         * ##
#   #              #
#        #        ##
#  #*            # #
#    #       #   # #
#       *      *   #
# ##    *   ## **  #
##       * #    #* #
#  #     *#*      *#
#   *    #     # * #
#   ##  #       #  #
# #   #     *    # #
####################
