13 31
###############################
#P  1 * * *  U *   *  * * 2   #
# # # #*# # #*#*# # # #*#*#*# #
#  x*     ***  *  U   * O * * #
# # # # # #*# # #*#*# # # # #*#
#          x **  *  *   U     #
# # # # # # # # # #*# #*# # # #
#*  *   1  *  *2     *        #
# # # # #*# # # #*#*# # # # # #
#*    **  *   4   *     U     #
# #*# # # # # # #*# # # # # # #
#  O   1    *   *  *    O     #
###############################