13 31
###############################
#P  1 * * *    *   *  * * 2   #
# # # #*# # #*#*# # # #*#*#*# #
#  x*     ***  *      *   * * #
# # # # # #*# # #*#*# # # # #*#
#          x **  *  *         #
# # # # # # # # # #*# #*# # # #
#*  *   1  *  *2     *        #
# # # # #*# # # #*#*# # # # # #
#*    **  *   4   *   3       #
# #*# # # # # # #*# # # # # # #
#      1    *   *  *          #
###############################