13 31
###############################
#P  1 * * *    *   *  * * 2   #
# # # #*# # #*#*# # # #*#*#*# #
#  x*  5  ***  *   U  *   * * #
# # # # # #*# # #*#*# # # # #*#
#    O     x **  *  *         #
# # # # # # # # # #*# #*# # # #
#*  *   1  *  *2     *   O    #
# # # # #*# # # #*#*# # # # # #
#*    **  *   4   *   3       #
# #*# # # # # # #*# # # # # # #
#      1    *   *  *          #
###############################