13 31
###############################
#P  1 * * *    *   *  * * 2   #
# # # #*# # #*#*# # # #*#*#*# #
#  x*  5  ***  *      *   * * #
# # # # # #*# # #*#*# # # # #*#
#          x **  *  *         #
# # # # # # # # # #*# #*# # # #
#*  *   1  *  *2     *        #
# # # # #**************** # # #
#*    **  *   4   *   3       #
# #*# # # # # # #*# # # # # # #
#      1    *   *  *          #
###############################