13 31
###############################
#P       *  *  4   2          #
# *************************** #
#                           * #
# #x######  U# U ######3### * #
# *                     U O * #
# # 2 1### * 1 ##***#### 1  * #
# # #         O          *  * #
# # ###################3##  * #
# #       *   4   *     U   * #
# *************************** #
#      1    *   *  *    *     #
###############################