####################
#**  *   #         #
# #  *  ** *##* #  #
#   # *  *   #     #
#  x *   #  #    x #
#     *** *   #  ###
#  *# # *x#   **  ##
#   *  *  #   * * ##
#*     *##     ##* #
#    # *   **    # #
#**  *  * *  *#*  *#
#  #*** *          #
#*#*      #*# #    #
# *   *  *       * #
####################
