####################
# O * *    *       #
#       *     #    #
# #  U    #*    #  #
#  x      *  O    ##
#  *    #          #
#  *  *       *    #
# # #  *         x #
#  O  **      #    #
#*#     #*      # *#
#** *   **     * U #
#     *     ***    #
# O       #* * #*  #
#    *        U   ##
#      # #*   * *  #
# ** #      * *    #
#  #    #  O  *  * #
#     * *   #  #  ##
#* #*#        # * *#
####################
