####################
# #  #  * U   ##   #
# O *   #    *  #  #
# # # # #  U # # # #
#  #   U      *   ##
# *  #  # ***  #  *#
# # U   #  #  *    #
# * #   *  # # **  #
#  ** * *#  # #  U #
#  #    ** #   *   #
#  #  *  * U #  #  #
#  # * *    #   *  #
# U   **#   O      #
##  *#     *** #  *#
#   *  *  **    *  #
#   *   #    *     #
# #  *    #*     * #
#   #  **#  #  *  ##
#*  x    U *  *   *#
####################
