13 31
###############################
#P  F * * *  U * O *  * * *   #
# # # #*# # #*#*# # # #*#*#*# #
#  x*   O ***  *  U   * O * * #
# # # # # #*# # #*#*# # # # #*#
#   O      x **  *  *   U     #
# # # # # # # # # #*# #*# # # #
#*  *   F  *  *      *        #
# # # # #*# # # #*#*# # # # # #
#*    **  *       *     U     #
# #*# # # # # # #*# # # # # # #
#  O   F    *   *  *    O     #
###############################