##########
#   #    #
# *###  ##
# ##* # ##
##*      #
#       ##
# # *    #
#  ##x x##
#   *  # #
##########
