####################
#    #  * U   ##   #
#   *   #    *  #  #
#           U      #
#  #   U      *   ##
#    #  # *    #  *#
# # U   #     *    #
# * #      # # **  #
#  ** * *#       U #
#  #    ** #   *   #
#     *   U    #   #
#  # * *    #   *  #
# U   **#          #
##  *#     *** #  *#
#   *  *  **    *  #
#   *   #    *     #
# #  *    #*     * #
#   #  **#  #     ##
#*  x    U        *#
####################
