13 31
###############################
#P  1 * * *    *   *  * * 2   #
# #                  O#*#*#*# #
#  x*  5  ***  *  U   *   * * #
# # # # # #*# # #*#*# # # # #*#
#    U     x **  *  *         #
# # # # # # # # # #*# #*# # # #
#*  *   1  *  *2     *      K #
# # # # #**************** # # #
#*    **  *   4   *   3       #
# #*# # # # # # #*# # # # # # #
#      1    *   *  *          #
###############################