13 31
###############################
#P  1 * * *  U *   *  * * 2   #
# # # #*# # #*#*# # # #*#*#*# #
#  x*     ***  *  O   *   * * #
# # # # # #*# # #*#*# # # # #*#
#     O    x **  *  *    U    #
# # # # # # # # # #*# #*# # # #
#*  *   1  *  *2     *   U    #
# # # # #*# # # #*#*# # # # # #
#*    **  *   4   *   3       #
# #*# # # # # # #*# # # # # # #
#      1    *   *  *     O    #
###############################