13 31
###############################
# P 1 * * *    3   *  * * 2   #
# #       4 U  U      #*#*#*# #
# 2x*  5  ***  *      *   * * #
# # # # 2 #*# # #*#*# # # # #*#
#          x **  *  *         #
# # # # # # # # # #*# #*# # # #
#*  *   1  *  *2     *        #
# 4 # # #**************** # # #
#*    **  *   4   *   3       #
# #*# # # # # # #*# # # #   # #
#      1    *   *  *          #
###############################