13 31
###############################
#P   U   *  *  4   2          #
# *************************** #
#                           * #
# #x######  U# U ######3### * #
# *                     U O * #
# # 2 1### * 1 ##***#### 1  * #
# # #         O    U     *  * #
# # ###################3##  * #
# #       *   4   *     U   * #
# *************************** #
#      1    *   *  *    *     #
###############################