13 31
###############################
#P                            #
#   # #*# # #*#*# # # #*#*#*# #
#  x*     ***         * ***** #
# # # # # #*# # #*#*# # # # #*#
#   *  O   x V*  *  *     O   #
# # # # # # # # # #*# #*# # # #
#*  *   1  *  *2  V  *    #   #
# # # # #*# # # #*#*# # # # # #
#*  K **  *K  4   *   3   #   #
# #*# # # # # # #*# # # # # # #
#      1    *   4  *    2     #
###############################