13 31
###############################
#P                            #
#   # #*# # #*#*# # # #*#*#*# #
#  x*     ***  *      * ***** #
# # # # # #*# # #*#*# # # # #*#
#   *      x **  *  *         #
# # # # # # # # # #*# #*# # # #
#*  *   1  *  *2     *    #   #
# # # # #*# # # #*#*# # # # # #
#*    **  *   4   *   3   #   #
# #*# # # # # # #*# # # # # # #
#      1    *   4  *    2     #
###############################