13 19
###################
#P  1 * * *    *  #
# # # #*# # #*#*# #
#   *     ***  *  #
# # # # # #*# # #*#
#            **  *#
# # # # # # # # # #
#*  *   1  *  *2  #
# # # # #*# # # #*#
#*    **  *   4   #
# #*# # # # # # #*#
#      1    *   * #
###################