13 31
###############################
#P         1           ##4    #
# *# # # # # # # # 3 # 1 K  * #
# ********      2    ******** #
# # # # ** ********** # # # #*#
#   *   *  x **  *  *         #
#   # # # # # # # #*#*#*# # # #
#*  *   *  *  *2     * V  #   #
#   # # #*### # #*#*#*# # # # #
#*V   **  *   4   *   3   #   #
#   # # # # # #   O    U  # # #
#  V   1    *   4  *    2     #
###############################