13 31
###############################
#P         1           ##4    #
# *************************** #
# ********      2    ******** #
# # # # ** ********** # # # #*#
#   *   *  x **  *  *         #
#   # # # # # # # #*#*#*# # # #
#*  *   *  *  *2     *    #   #
#   # # #*### # #*#*#*# # # # #
#*    **  *   4   *   3   #   #
#   # # # # # #   O    U  # # #
#      1    *   4  *    2     #
###############################