13 31
###############################
#P  *    5     3   U     * *  #
# ***       **       2   1    #
#     3       U         U     #
#  O   *         5            #
#         U   5          ***  #
#    *    1     4   O      U  #
#  K                  K       #
#*    2       1            3  #
#  U             O            #
#      1    *   *  *     U 2  #
###############################